3 3 3 3 3 3 3 3 3 3 3 3 3 3 3 3 3 3 3 3 3 3 3 3 3 3 3 3 3 3 3 3 3 3 3 3 3 3 3 3 3 3 3 3 3 3 3 3 3 3 
3 3 3 3 3 3 3 3 3 3 3 3 3 3 3 3 3 3 3 3 3 3 3 3 3 3 3 3 3 3 3 3 3 3 3 3 3 3 3 3 3 3 3 3 3 3 3 3 3 3 
3 3 3 3 3 3 3 3 3 3 3 3 3 3 3 3 3 3 3 3 3 3 3 3 3 3 3 3 3 3 3 3 3 3 3 3 3 3 3 3 3 3 3 3 3 3 3 3 3 3 
3 3 3 3 3 3 3 3 3 3 3 3 3 3 3 3 3 3 3 3 3 3 3 3 3 3 3 3 3 3 3 3 3 3 3 3 3 3 3 3 3 3 3 3 3 3 3 3 3 3 
3 3 3 3 3 3 3 3 3 3 3 3 3 3 3 3 3 3 3 3 3 3 3 3 3 3 3 3 3 3 3 3 3 3 3 3 3 3 3 3 3 3 3 3 3 3 3 3 3 3 
3 3 3 3 3 3 3 3 3 3 3 3 3 3 3 3 3 3 3 3 3 3 3 3 3 3 3 3 3 3 3 3 3 3 3 3 3 3 3 3 3 3 3 3 3 3 3 3 3 3 
3 3 3 3 3 3 3 3 3 3 3 3 3 3 3 3 3 3 3 3 3 3 3 3 3 3 3 3 3 3 3 3 3 3 3 3 3 3 3 3 3 3 3 3 3 3 3 3 3 3 
3 3 3 3 3 3 3 3 3 3 3 3 3 3 3 3 3 3 3 3 3 3 3 3 3 3 3 3 3 3 3 3 3 3 3 3 3 3 3 3 3 3 3 3 3 3 3 3 3 3 
3 3 3 3 3 3 3 3 3 3 3 3 4 4 4 4 4 4 4 3 3 4 4 4 4 4 4 4 4 3 3 4 4 4 4 4 4 4 3 3 3 3 3 3 3 3 3 3 3 3 
3 3 3 3 3 3 3 3 3 3 3 3 4 5 5 5 5 5 4 3 3 4 5 5 5 5 5 5 4 3 3 4 5 5 5 5 5 4 3 3 3 3 3 3 3 3 3 3 3 3 
3 3 3 3 3 3 3 3 3 3 3 3 4 5 2 2 2 5 4 3 3 4 5 5 5 5 5 5 4 3 3 4 5 2 2 2 5 4 3 3 3 3 3 3 3 3 3 3 3 3 
3 3 3 3 3 3 3 3 3 3 3 3 4 5 2 2 2 5 4 3 3 4 5 5 5 5 5 5 4 3 3 4 5 2 2 2 5 4 3 3 3 3 3 3 3 3 3 3 3 3 
3 3 3 3 3 3 3 3 3 3 3 3 4 5 2 2 2 5 4 3 3 4 4 4 4 4 4 4 4 3 3 4 5 2 2 2 5 4 3 3 3 3 3 3 3 3 3 3 3 3 
3 3 3 3 3 3 3 3 3 3 3 3 4 5 2 2 2 5 4 3 3 3 3 3 3 3 3 3 3 3 3 4 5 2 2 2 5 4 3 3 3 3 3 3 3 3 3 3 3 3 
3 3 3 3 4 4 4 4 3 0 0 0 0 0 0 0 0 0 0 0 0 0 0 0 0 0 0 0 0 0 0 0 0 0 0 0 0 0 0 0 0 3 4 4 4 4 3 3 3 3 
3 3 3 3 4 5 5 4 3 0 0 0 0 0 0 0 0 0 0 0 0 0 0 0 0 0 0 0 0 0 0 0 0 0 0 0 0 0 0 0 0 3 4 5 5 4 3 3 3 3 
3 3 3 3 4 5 5 4 3 0 0 3 3 3 3 3 3 3 3 3 3 3 3 0 0 0 0 3 3 3 3 3 3 3 3 3 3 3 3 0 0 3 4 5 5 4 3 3 3 3 
3 3 3 3 4 5 5 4 3 0 0 3 4 4 4 4 3 3 3 4 4 4 4 2 2 2 2 4 4 4 4 3 3 3 4 4 4 4 3 0 0 3 4 5 5 4 3 3 3 3 
3 3 3 3 4 4 4 4 3 0 0 3 4 5 5 4 3 3 3 4 5 5 4 2 2 2 2 4 5 5 4 3 3 3 4 5 5 4 3 0 0 3 4 4 4 4 3 3 3 3 
3 3 3 3 3 3 3 3 3 0 0 3 4 5 5 4 3 3 3 4 5 5 4 2 2 2 2 4 5 5 4 3 3 3 4 5 5 4 3 0 0 3 3 3 3 3 3 3 3 3 
3 3 3 3 3 2 2 2 3 0 0 3 4 5 5 4 3 3 3 4 5 5 4 2 2 2 2 4 5 5 4 3 3 3 4 5 5 4 3 0 0 3 2 2 2 3 3 3 3 3 
3 3 3 3 3 2 2 2 2 0 0 3 4 5 5 4 3 3 3 4 5 5 4 2 2 2 2 4 5 5 4 3 3 3 4 5 5 4 3 0 0 2 2 2 2 3 3 3 3 3 
3 3 3 3 3 2 2 2 3 0 0 3 4 5 5 4 3 3 3 4 5 5 4 2 2 2 2 4 5 5 4 3 3 3 4 5 5 4 3 0 0 3 2 2 2 3 3 3 3 3 
3 3 3 3 3 3 3 3 3 0 0 3 4 5 5 4 3 3 3 4 5 5 4 2 2 2 2 4 5 5 4 3 3 3 4 5 5 4 3 0 0 3 3 3 3 3 3 3 3 3 
3 3 3 3 4 4 4 4 3 0 0 3 4 5 5 4 3 3 3 4 5 5 4 2 2 2 2 4 5 5 4 3 3 3 4 5 5 4 3 0 0 3 4 4 4 4 3 3 3 3 
3 3 3 3 4 5 5 4 3 0 0 3 4 4 4 4 3 3 3 4 4 4 4 2 2 2 2 4 4 4 4 3 3 3 4 4 4 4 3 0 0 3 4 5 5 4 3 3 3 3 
3 3 3 3 4 5 5 4 3 0 0 3 3 3 3 3 3 3 3 3 3 3 3 3 0 0 3 3 3 3 3 3 3 3 3 3 3 3 3 0 0 3 4 5 5 4 3 3 3 3 
3 3 3 3 4 5 5 4 3 0 0 3 3 3 3 3 3 3 3 3 3 3 3 3 0 0 3 3 3 3 3 3 3 3 3 3 3 3 3 0 0 3 4 5 5 4 3 3 3 3 
3 3 3 3 4 5 5 4 3 0 0 0 0 0 0 0 0 0 0 0 0 0 0 0 0 0 0 0 0 0 0 0 0 0 0 0 0 0 0 0 0 3 4 5 5 4 3 3 3 3 
3 3 3 3 4 4 4 4 3 0 0 0 0 0 0 0 0 0 0 0 0 0 0 0 0 0 0 0 0 0 0 0 0 0 0 0 0 0 0 0 0 3 4 4 4 4 3 3 3 3 
3 3 3 3 3 3 3 3 3 3 3 3 3 3 3 3 5 2 5 3 3 3 3 3 3 3 3 3 3 3 3 5 2 5 3 3 3 3 3 3 3 3 3 3 3 3 3 3 3 3 
3 3 3 3 3 3 3 3 3 3 3 3 3 3 3 3 2 2 2 3 4 4 4 4 4 4 4 4 4 4 3 2 2 2 3 3 3 3 3 3 3 3 3 3 3 3 3 3 3 3 
3 3 3 3 3 3 3 3 3 3 3 3 3 3 3 3 2 2 2 3 4 5 5 5 5 5 5 5 5 4 3 2 2 2 3 3 3 3 3 3 3 3 3 3 3 3 3 3 3 3 
3 3 3 3 3 3 3 3 3 3 3 3 3 3 3 3 2 2 2 3 4 5 5 5 5 5 5 5 5 4 3 2 2 2 3 3 3 3 3 3 3 3 3 3 3 3 3 3 3 3 
3 3 3 3 3 3 3 3 3 3 3 3 3 3 3 3 2 2 2 3 4 4 4 4 4 4 4 4 4 4 3 2 2 2 3 3 3 3 3 3 3 3 3 3 3 3 3 3 3 3 
3 3 3 3 3 3 3 3 3 3 3 3 3 3 3 3 2 2 2 3 3 3 3 3 3 3 3 3 3 3 3 2 2 2 3 3 3 3 3 3 3 3 3 3 3 3 3 3 3 3 
3 3 3 3 3 3 3 3 3 3 3 3 3 3 3 3 2 2 2 2 2 2 2 2 2 2 2 2 2 2 2 2 2 2 3 3 3 3 3 3 3 3 3 3 3 3 3 3 3 3 
3 3 3 3 3 3 3 3 3 3 3 3 3 3 3 3 2 2 2 2 2 2 2 2 2 2 2 2 2 2 2 2 2 2 3 3 3 3 3 3 3 3 3 3 3 3 3 3 3 3 
3 3 3 3 3 3 3 3 3 3 3 3 3 3 3 3 2 2 2 2 2 2 2 2 2 2 2 2 2 2 2 2 2 2 3 3 3 3 3 3 3 3 3 3 3 3 3 3 3 3 
3 3 3 3 3 3 3 3 3 3 3 3 3 3 3 3 3 3 3 3 3 3 3 3 1 3 3 3 3 3 3 3 3 3 3 3 3 3 3 3 3 3 3 3 3 3 3 3 3 3 
3 3 3 3 3 3 3 3 3 3 3 3 3 3 3 3 3 3 3 3 3 0 0 0 0 0 0 0 3 3 3 3 3 3 3 3 3 3 3 3 3 3 3 3 3 3 3 3 3 3 
3 3 3 3 3 3 3 3 3 3 3 3 3 3 3 3 3 3 3 3 3 0 0 2 2 2 0 0 3 3 3 3 3 3 3 3 3 3 3 3 3 3 3 3 3 3 3 3 3 3 
3 3 3 3 3 3 3 3 3 3 3 3 3 3 3 3 3 3 3 3 3 0 0 2 2 2 0 0 3 3 3 3 3 3 3 3 3 3 3 3 3 3 3 3 3 3 3 3 3 3 
3 3 3 3 3 3 3 3 3 3 3 3 3 3 3 3 3 3 3 3 3 0 0 2 2 2 0 0 3 3 3 3 3 3 3 3 3 3 3 3 3 3 3 3 3 3 3 3 3 3 
3 3 3 3 3 3 3 3 3 3 3 3 3 3 3 3 3 3 3 3 3 0 0 0 0 0 0 0 3 3 3 3 3 3 3 3 3 3 3 3 3 3 3 3 3 3 3 3 3 3 
3 3 3 3 3 3 3 3 3 3 3 3 3 3 3 3 3 3 3 3 3 3 3 3 3 3 3 3 3 3 3 3 3 3 3 3 3 3 3 3 3 3 3 3 3 3 3 3 3 3 
3 3 3 3 3 3 3 3 3 3 3 3 3 3 3 3 3 3 3 3 3 3 3 3 3 3 3 3 3 3 3 3 3 3 3 3 3 3 3 3 3 3 3 3 3 3 3 3 3 3 
3 3 3 3 3 3 3 3 3 3 3 3 3 3 3 3 3 3 3 3 3 3 3 3 3 3 3 3 3 3 3 3 3 3 3 3 3 3 3 3 3 3 3 3 3 3 3 3 3 3 
3 3 3 3 3 3 3 3 3 3 3 3 3 3 3 3 3 3 3 3 3 3 3 3 3 3 3 3 3 3 3 3 3 3 3 3 3 3 3 3 3 3 3 3 3 3 3 3 3 3 
3 3 3 3 3 3 3 3 3 3 3 3 3 3 3 3 3 3 3 3 3 3 3 3 3 3 3 3 3 3 3 3 3 3 3 3 3 3 3 3 3 3 3 3 3 3 3 3 3 3 
